Ewa's map
25
25
W10 W5 W4 S0 G8 G4 G4 G4 G4 G4 G4 G4 G4 G4 G4 G4 R1 G4 G4 R3 R3 R3 R3 R3 R2 
W10 W5 W4 S0 G8 G0 G0 G0 G0 G0 G0 G0 G0 G0 G0 G0 R1 G5 G5 G5 W6 W1 W18 T1 R2
W15 W13 W14 S0 G8 G0 G0 G0 G0 G0 G0 G0 G0 G0 G0 G0 R1 T1 G6 G6 W6 W1 W18 G6 R2
S0 S0 S0 S0 G8 G0 G0 G0 G0 G0 G0 G0 G0 G0 G0 G0 R1 G6 T1 G6 W6 W1 W18 G6 R2
G9 G9 G9 G9 R0 G0 G0 G0 G0 G0 G0 G0 G0 G0 G0 G0 R1 G6 G6 G6 G4 G4 G4 G4 R2
G4 G0 G0 G0 G0 G0 G0 G0 G0 G0 G0 G0 G0 G0 G0 G0 G0 G0 G0 G0 G0 G0 G0 G0 G4
G4 G0 G0 W6 W1 W1 W1 G0 G0 G0 G0 G0 G0 G0 G0 G0 G0 G0 G0 G0 G0 G2 G0 G0 G4
G4 G0 G0 W6 W1 W1 W1 G0 G0 G0 G0 G0 G0 G0 G2 G0 G0 G0 G0 G0 G0 G0 G0 G0 G4
G4 G0 G0 W6 W1 W1 W1 G0 G0 G0 G0 G0 G0 G0 G0 G0 G0 G0 G0 G0 G0 G0 G0 G0 G4
G4 G0 G0 G0 G0 G0 G0 G0 G0 G0 G0 G0 G0 G0 G0 G0 G0 G0 G1 G0 G0 G0 G0 G0 G4
G4 G0 G0 G0 G0 G0 G0 G0 G0 G0 G0 G0 G0 G0 G0 G0 G0 G0 S0 G0 G0 W0 G0 G0 G4
G4 G0 G0 G0 G0 G0 G0 G0 G0 G0 G0 G0 G0 G4 G4 G4 G4 G0 G0 G0 G0 W7 G0 G0 G4
G4 G0 G0 G0 G0 G0 G0 G0 G0 G0 G0 G0 T0 G0 G0 G0 G0 G0 G0 G0 G0 G0 G0 G0 G4
G4 G0 G0 G2 G0 G0 G0 G0 G0 G0 G0 T0 T0 G0 G0 G0 G0 G0 G0 G0 G0 G0 G0 G0 G4
G4 G0 G0 G0 G0 G0 G0 G0 G2 G0 G0 G0 G0 G0 G0 G0 G0 G0 G0 G0 G0 G0 G0 G0 G4
G4 G0 G0 G0 G0 G0 G0 G0 G0 G0 G0 G0 G0 G0 W2 G0 G4 G4 G4 G4 G0 G0 G0 G0 G4
G4 G0 G0 G0 G0 G0 G0 G0 G0 G0 R0 G0 G0 G0 W7 G0 G0 G0 G0 G0 G0 G0 G0 G0 G4
G4 G0 G0 G0 G0 G0 G0 G0 G0 G0 G0 G0 G0 G0 G0 G0 G0 G0 G0 G0 G0 G0 G0 G0 G4
G4 G0 G0 G0 G0 G0 G0 G0 G0 G0 G0 G0 G0 G0 G0 G0 G0 G0 G0 G0 G0 G0 G0 G0 G4
G4 G0 G0 G0 G0 G0 R0 W2 G0 G0 G0 G0 G0 G0 G0 G0 G0 G0 R0 G0 G0 G0 G0 G0 G4
R2 G6 G6 G6 G4 G4 G4 G4 R1 G0 G0 G0 G0 G0 G0 G0 G0 G0 G0 G0 G0 G0 G0 G0 G4
R2 G6 T1 G6 W6 W1 W18 G6 R1 G0 G0 G0 G0 G0 G2 G0 G0 G0 G0 G0 G0 G0 W16 W8 W2
R2 T1 G6 G6 W6 W1 W18 G6 R1 G0 G0 G0 G0 G0 G0 G0 G0 G0 G0 G0 G0 G0 W10 W5 W4
R2 G5 G5 G5 W6 W1 W18 T1 R1 G0 G0 G0 G0 G0 G0 G0 G0 G0 G0 G0 G0 G0 W10 W5 W4
R2 G4 G4 R3 R3 R3 R3 R3 R3 G4 G4 G4 G4 G4 G4 G4 G4 G4 G4 G4 G4 G4 W10 W5 W4


