Justin's map
25
25
W10 W5 W4 S0 G8 G4 G4 G4 G4 G4 G4 G4 G4 G4 G4 G4 G4 G4 G4 G4 G4 G4 G4 G4 G4 
W10 W5 W4 S0 G8 G0 G0 G0 G0 G0 G0 G0 G0 G0 G0 G0 G0 G0 G0 G0 G0 G0 G0 G0 G4
W15 W13 W14 S0 G8 G0 G0 G0 G0 G0 G0 G0 G0 G0 G0 G0 G0 G0 G0 G0 G0 G0 R1 G0 G4
S0 S0 S0 S0 G8 G0 G0 G0 G0 G0 G0 G0 G0 G0 G0 G0 G0 G0 G0 G0 G0 G0 G0 G0 G4
G9 G9 G9 G9 R0 G0 G0 G0 G0 G0 G0 G0 G0 G0 G0 G0 G0 G0 G0 R0 G0 G0 G0 G0 G4
G4 G0 G0 G0 G0 G0 G0 G0 G0 G0 G0 G0 G0 G0 G0 G0 G0 G0 G0 G0 G0 G0 G0 G0 G4
G4 G0 G0 W6 W1 W1 W1 G0 G0 G0 G0 G0 G0 G0 G0 G0 G0 G0 G0 G0 G0 G2 G0 G0 G4
G4 G0 G0 W6 W1 W1 W1 G0 G0 G0 G0 G0 G0 G0 G2 G0 G0 G0 G0 G0 G0 G0 G0 G0 G4
G4 G0 G0 W6 W1 W1 W1 G0 G0 G0 G0 G0 G0 G0 G0 G0 G0 G0 G0 G0 G0 G0 G0 G0 G4
G4 G0 G0 G0 G0 G0 G0 G0 G0 G0 G0 G0 G0 G0 G0 G0 G0 G0 G1 G0 G0 G0 G0 G0 G4
G4 G0 G0 G0 G0 G0 G0 G0 G0 G0 G0 G0 G0 G0 G0 G0 G0 G0 S0 G0 G0 W0 G0 G0 G4
G4 G0 G0 G0 G0 G0 G0 G0 G0 G0 G0 G0 G0 G0 G0 G0 G0 G0 G0 G0 G0 W7 G0 G0 G4
G4 G0 G0 G0 G0 G0 G0 G0 G0 G0 G0 G0 T0 G0 G0 G0 G0 G0 G0 G0 G0 G0 G0 G0 G4
G4 G0 G0 G2 G0 G0 G0 G0 G0 G0 G0 G0 G0 G0 G0 G0 G0 G0 G0 G0 G0 G0 G0 G0 G4
G4 G0 G0 G0 G0 G0 G0 G0 G2 G0 G0 G0 G0 G0 G0 G0 G0 G0 G0 G0 G0 G0 G0 G0 G4
G4 G0 G0 G0 G0 G0 G0 G0 G0 G0 G0 G0 G0 G0 W2 G0 G0 G0 G0 G0 G0 G0 G0 G0 G4
G4 G0 G0 G0 G0 G0 G0 G0 G0 G0 R0 G0 G0 G0 W7 G0 G0 G0 G0 G0 G0 G0 G0 G0 G4
G4 G0 G0 G0 G0 G0 G0 G0 G0 G0 G0 G0 G0 G0 G0 G0 G0 G0 G0 G0 G0 G0 G0 G0 G4
G4 G0 G0 G0 G0 G0 G0 G0 G0 G0 G0 G0 G0 G0 G0 G0 G0 G0 G0 G0 G0 G0 G0 G0 G4
G4 G0 G0 G0 G0 G0 R0 W2 G0 G0 G0 G0 G0 G0 G0 G0 G0 G0 R0 G0 G0 G0 G0 G0 G4
G4 G0 G0 G0 G0 W5 W3 W4 G0 G0 G0 G0 G0 G0 G0 G0 G0 G0 G0 G0 G0 G0 G0 G0 G4
G4 G0 G0 G0 G0 G0 G0 G0 G0 G0 G0 G0 G0 G0 G2 G0 G0 G0 G0 G0 G0 G0 W16 W8 W2
G4 G0 R1 G0 G0 G0 G0 G0 G0 G0 G0 G0 G0 G0 G0 G0 G0 G0 G0 G0 G0 G0 W10 W5 W4
G4 G0 G0 G0 G0 G0 G0 G0 G0 G0 G0 G0 G0 G0 G0 G0 G0 G0 G0 G0 G0 G0 W10 W5 W4
G4 G4 G4 G4 G4 G4 G4 G4 G4 G4 G4 G4 G4 G4 G4 G4 G4 G4 G4 G4 G4 G4 W10 W5 W4


